### level_4 ###
# (row,col) #
#
2,5,1	2,6,1	2,7,1	2,8,1	2,9,1	2,10,1	2,11,1	2,12,1	2,13,1	2,14,1
2,15,1	2,16,1	3,4,1	3,6,1	3,17,1	4,3,1	4,7,1	4,18,1	5,2,1	5,3,1
5,4,1	5,5,1	5,6,1	5,7,1	5,8,1	5,9,1	5,10,1	5,11,1	5,12,1	5,13,1
5,14,1	5,15,1	5,16,1	5,17,1	5,18,1	5,19,1	6,2,1	6,19,1	7,2,1	7,4,2
7,5,2	7,9,2	7,10,2	7,12,2	7,13,2	7,15,2	7,16,2	7,19,1	8,2,1	8,4,2
8,5,2	8,9,2	8,10,2	8,12,2	8,13,2	8,15,2	8,16,2	8,19,1	9,2,1	9,4,2
9,5,2	9,19,1	10,2,1	10,3,1	10,4,1	10,5,1	10,6,1	10,7,1	10,8,1	10,9,1
10,10,1	10,11,1	10,12,1	10,13,1	10,14,1	10,15,1	10,16,1	10,17,1	10,18,1	10,19,1
