### level_3 ###
# (row,col) #
#
1,2,1	1,5,1	1,6,1	1,9,1	1,12,1	1,15,1	2,1,1	2,3,1	2,5,1	2,7,1
2,9,1	2,11,1	2,14,1	2,16,1	3,1,1	3,2,1	3,3,1	3,5,1	3,6,1	3,9,1
3,10,1	3,14,1	3,15,1	3,16,1	4,1,1	4,3,1	4,5,1	4,7,1	4,9,1	4,11,1
4,14,1	4,16,1	5,1,1	5,3,1	5,5,1	5,7,1	5,9,1	5,12,1	5,14,1	5,16,1
6,1,2	6,2,2	6,3,2	6,4,2	6,5,2	6,6,2	6,7,2	6,8,2	6,9,2	6,10,2
6,11,2	6,12,2	6,13,2	6,14,2	6,15,2	6,16,2	6,17,2	6,18,2	6,19,2	6,20,2
7,2,1	7,5,1	7,8,1	7,11,1	7,13,1	7,14,1	7,18,1	8,2,1	8,3,1	8,5,1
8,7,1	8,9,1	8,11,1	8,13,1	8,15,1	8,17,1	8,19,1	9,2,1	9,4,1	9,5,1
9,7,1	9,9,1	9,11,1	9,13,1	9,15,1	9,17,1	9,18,1	9,19,1	10,2,1	10,5,1
10,8,1	10,11,1	10,13,1	10,14,1	10,17,1	10,19,1
