### paulinka ###
# (row,col) #
#
2,7,1	2,8,1	2,9,1	2,10,1
2,11,1	3,11,1	4,11,1	5,11,1	5,13,1	5,14,1	5,15,1	5,18,1	5,19,1	5,20,1
6,6,1	6,7,1	6,8,1	6,9,1	6,10,1
6,11,1	6,13,1	6,16,1	6,18,1	6,20,1
7,6,1	7,11,1	7,13,1	7,16,1	7,18,1	7,20,1
8,6,1	8,11,1	8,13,1	8,16,1	8,18,1	8,20,1
9,6,1	9,7,1	9,8,1	9,9,1	9,10,1
9,11,1	9,13,1	9,16,1	9,18,1	9,19,1	9,20,1
