### wabco ###
# (row,col) #
#
1,1,1	1,5,1	1,8,1	1,11,1	1,12,1	1,15,1	1,16,1	1,19,1	2,1,1	2,5,1	2,7,1	2,9,1	2,11,1	2,13,1	2,14,1	2,18,1	2,20,1
3,1,1	3,3,1	3,5,1	3,7,1	3,9,1	3,11,1	3,12,1	3,13,1	3,14,1	3,18,1	3,20,1
4,2,1	4,3,1	4,4,1	4,6,1	4,7,1	4,8,1	4,9,1	4,10,1
4,11,1	4,12,1	4,13,1	4,14,1	4,18,1	4,20,1
5,2,1	5,4,1	5,6,1	5,10,1
5,11,1	5,13,1	5,14,1	5,18,1	5,20,1
6,2,1	6,4,1	6,6,1	6,10,1
6,11,1	6,12,1	6,15,1	6,16,1	6,19,1	9,1,2	9,3,2	9,5,2	9,7,2	9,9,2	9,11,2	9,13,2	9,15,2	9,17,2	9,19,2	10,2,2	10,4,2	10,6,2	10,8,2	10,10,2
10,12,2	10,14,2	10,16,2	10,18,2	10,20,2
